Date,Description,Reference,Debit,Credit,Balance
2025-10-28,Payment Arjun Kumar,REF-EXACT-001,,5000.00,50000.00
2025-10-27,Transfer Arjun,REF-WITHIN1-002,,4999.00,45001.00
2025-10-20,Old payment,REF-DATE-FAR-005,,5000.00,40001.00
2025-10-28,Wrong amount same ref,REF-AMOUNT-MISMATCH-006,,5050.00,34951.00
2025-10-28,Random transaction,RANDOM-REF-999,,1500.00,33451.00
2025-11-05,Future dated transaction,FUTURE-001,,5000.00,28451.00

